{
  "map": [
    [0, 0, 0, 0, 0, 0, 0, 0, 0, 0, 0, 0],
    [2, 0, 0, 0, 0, 0, 0, 0, 4, 2, 0, 1],
    [0, 0, 0, 1, 0, 3, 0, 0, 0, 0, 0, 0],
    [0, 0, 3, 0, 0, 0, 4, 4, 0, 1, 0, 0],
    [0, 1, 2, 0, 0, 0, 0, 5, 4, 0, 0, 5]
  ],
  "scoreRequire": 4000,
  "index": 2
}
